###.................###
#.....................#
#...%%%.%%%.%%%.%%%...#
.....%..%...%....%.....
.....%..%%%.%%%..%.....
.....%..%.....%..%.....
.....%..%%%.%%%..%.....
.......................
.....%...%.%%%.%%%.....
.....%%.%%.%.%.%.%.....
.....%.%.%.%%%.%%%.....
.....%...%.%.%.%.......
.....%...%.%.%.%.......
.......................
.......................
#...........@.........#
#.....................#
###.................###
