###.....................###
#.........................#
#.....%%%.%%%.%%%.%%%.....#
.......%..%...%....%.......
.......%..%%%.%%%..%.......
.......%..%.....%..%.......
.......%..%%%.%%%..%.......
...........................
.......%...%.%%%.%%%.......
.......%%.%%.%.%.%.%.......
.......%.%.%.%%%.%%%.......
.......%...%.%.%.%.........
.......%...%.%.%.%.........
...........................
...........................
#.............@...........#
#.........................#
###.....................###
