##...........##
#.............#
....%%%%%%%....
...%%%%%%%%%...
...............
...............
...............
.......@.......
...............
...............
...............
...%%%%%%%%%...
....%%%%%%%....
#.............#
##...........##
