...............
.%%%%....%%%%%.
.%##.......##%.
.%#.........#%.
.%...........%.
...............
...............
...............
.......@.......
...............
.%...........%.
.%#.........#%.
.%##.......##%.
.%%%%.....%%%%.
...............
